11111111111111111111111111111111
11111111111111111111111111111111
11111111111111111111111111111111
11111111111111111111111111111111
11111111111111111111111111111111
11111111222222222222221111111111
11111111233333333333321111111111
11111111233333333333321111111111
11111111233333333333321111111111
11111111233333333333321111111111
11111111233333333333321111111111
11111111233333333333321111111111
11111111233333333333321111111111
11111111222222222322221111111111
11111111111111112321111111111111
11111111111111112322222221111111
11111111111111112333333321111111
11111111111111112222222321111111
11111111111111111111112321111111
11111111111111111111112321111111
11111111111111222222222322222111
11111111111111233333333333332111
11111111111111233333333333332111
11111111111111222222222222222111
